M M M M M M M M M M M M M M M M M M M M M M M M M 
M V L L L M M M M M M M M M M M M M M M M M M M M 
M M M M L M M M M M M M M M M M M M M M M M M M M 
M M M M L M M M M M M M M M M M M M M M M M M M M 
M M M M L M M M M M M M M M M M M M M M M M M M M 
M M M M L L L L L L M M M M M M M M M M M M M M M 
M M M M M M M M M L M M M M M M L L L L L M M M M 
M M M M M M M M M L M M M M M M M M M M L M M M M 
M M M M M M M M M H M M M M M M L L L L L M M M M 
M L L L L L L L L L M M M M M M L M M M M M M M M 
M L M M M M M M M M M M M M M M L L L L L L M M M 
M L M M M M M M M M M M M M M M M M M M M L M M M 
M L M M M L L L L L C L L L L L L L L M M L M M M 
M L M M M L M M M M M M M M M M M M L M M L M M M 
M L M M M L M M M M M M M M M M M M L B M L M M M 
M L L L L L M M M M M M M M M M M M L M M L M M M 
M M M M M M M M M M M M M M M M M M L M M L M M M 
M M M M M M M M M M M M M M M M M M L M M L M M M 
M M M M M M M M M M M M M M M M M M L M M L M M M 
M M M M M M M M M M M M M M M M M M L M M L L L M 
M M M M M M M M M M M M M M M M M M L M M M M L M 
M M M M M M M M M M M M M M M M M M L L L L L L M 
M M M M M M M M M M M M M M M M M M M M M M L S M 
M M M M M M M M M M M M M M M M M M M M M M M M M 
M M M M M M M M M M M M M M M M M M M M M M M M M 
