M M M M M M M M M M M M M M M M M M M M M M M M M 
M V L L L M M M M M M M M M M M M M M M M M M M M 
M M M M L M M M M M M M M M M M M M M M M M M M M 
M M M M L M M M M M M M M M M M M M M M M M M M M 
M M M M L M M M M M M M M M M M M M M M M M M M M 
M M M M L L L L L L M M M M M M M M M M M M M M M 
M M M M M M M M M L M M M M M M M M M M M M M M M 
M M M M M M M M M L M M M M M M M M M M M M M M M 
M M M M M M M M M L M M M M M M M M M M M M M M M 
M L L L L L L L L L M M M M M M M M M M M M M M M 
M L M M M M M M M M M M M M M M M M M M M M M M M 
M L M M M M M M M M M M M M M M M M M M M M M M M 
M L M M M L L L L L L L L L L L L L L M M M M M M 
M L M M M L M M M M M M M M M M M M L M M M M M M 
M L M M M L M M M M M M M M M M M M L M M M M M M 
M L L L L L M M M M M M M M M M M M L M M M M M M 
M M M M M M M M M M M M M M M M M M L M M M M M M 
M M M M M M M M M M M M M M M M M M L M M M M M M 
M M M M M M M M M M M M M M M M M M L M M M M M M 
M M M M M M M M M M M M M M M M M M L M M M M M M 
M M M M M M M M M M M M M M M M M M L M M M M M M 
M M M M M M M M M M M M M M M M M M L L L L L M M 
M M M M M M M M M M M M M M M M M M M M M M L S M 
M M M M M M M M M M M M M M M M M M M M M M M M M 
M M M M M M M M M M M M M M M M M M M M M M M M M 
